##############################
#                            #
#                            #
#   ++ +  +   +    +         #
#  --   -    -   -  - --     #
#   --                +      #
#    -                  +    #
#    -                    +  #
#                            #
##############################